CXXXDXXXC
X..B.B..X
X..B.B..X
XBBB.BBBX
D.......D
XBBB.BBBX
X..B.B..X
X..B.B..X
CXXXDXXXC